--|---------|---------|---------|---------|---------|---------|-----
01|>                     3/3 ╭─────────────────foo─────────────────╮
02|───────────────────────── │  1 SELECTED FILE: foo               │
03|▌ foo                     │                                     │
04|  bar                     │                                     │
05|  baz                     │                                     │
06|                          │                                     │
07|                          │                                     │
08|                          │                                     │
09|                          │                                     │
10|                          │                                     │
11|                          │                                     │
12|                          │                                     │
13|                          │                                     │
14|                          │                                     │
15|                          │                                     │
16|                          │                                     │
17|                          │                                     │
18|                          │                                     │
19|                          │                                     │
20|                          │                                     │
21|                          │                                     │
22|                          │                                     │
23|                          ╰─────────────────────────────────────╯
24|<d/bhagwan/Sources/nvim/fzf-lua//10360:/bin/sh 1,3            All
25|                                                                 
26|                                                                 
27|                                                                 
28|-- TERMINAL --                                                   
